20 20 20 20 20 20 20 20 20 20 20 20 20 20
20 20 20 20 20 20 20 20 20 20 20 20 20 20
20 20 1 2 2 2 2 2 2 2 2 3 20 20
20 20 4 13 13 14 13 13 13 14 13 5 20 20
20 20 4 13 13 13 14 13 14 14 13 5 20 20
20 20 4 14 13 13 13 13 13 13 13 5 20 20
20 0 4 14 13 13 13 13 13 14 14 5 0 20
20 0 4 13 13 14 13 13 13 13 13 5 0 20
20 20 4 14 13 13 13 14 13 13 13 5 20 20
20 20 4 13 14 13 14 13 13 13 14 5 20 20
20 20 4 13 13 13 13 13 13 13 13 5 20 20
20 20 6 7 7 7 7 7 7 7 7 8 20 20
20 20 20 20 20 20 20 20 20 20 20 20 20 20
20 20 20 20 20 20 20 20 20 20 20 20 20 20